g__Escherichia;s__coli	Escherichia coli	大肠埃希菌	G-
g__Staphylococcus;s__aureus	Staphylococcus aureus	金黄色葡萄球菌	G+
g__Klebsiella;s__pneumoniae	Klebsiella pneumoniae	肺炎克雷伯菌	G-
g__Staphylococcus;s__epidermidis	Staphylococcus epidermidis	表皮葡萄球菌	G+
g__Proteus;s__mirabilis	Proteus mirabilis	奇异变形菌	G-
g__Staphylococcus;s__hominis	Staphylococcus hominis	人葡萄球菌	G+
g__Proteus;s__vulgaris	Proteus vulgaris	普通变形菌	G-
g__Staphylococcus;s__saprophyticus	Staphylococcus saprophyticus	腐生葡萄球菌	G+
g__Proteus;s__penneri	Proteus penneri	彭氏变形菌	G-
g__Staphylococcus;s__haemolyticus	Staphylococcus haemolyticus	出血性葡萄球菌	G+
g__Enterobacter;s__cloacae	Enterobacter cloacae	阴沟肠杆菌	G-
g__Staphylococcus;s__schleiferi	Staphylococcus schleiferi	施氏葡萄球菌	G+
g__Citrobacter;s__freundii	Citrobacter freundii	弗氏柠檬酸杆菌	G-
g__Staphylococcus;s__warneri	Staphylococcus warneri	沃氏葡萄球菌	G+
g__Citrobacter;s__koseri	Citrobacter koseri	柯氏柠檬酸杆菌	G-
g__Enterococcus;s__faecalis	Enterococcus faecalis	粪肠球菌	G+
g__Serratia;s__marcescens	Serratia marcescens	粘质沙雷氏菌	G-
g__Enterococcus;s__faecium	Enterococcus faecium	屎肠球菌	G+
g__Pseudomonas;s__aeruginosa	Pseudomonas aeruginosa	铜绿假单胞菌	G-
g__Enterococcus;s__gallinarum	Enterococcus gallinarum	鹑鸡肠球菌	G+
g__Pseudomonas;s__putida	Pseudomonas putida	恶臭假单胞菌	G-
g__Streptococcus;s__agalactiae	Streptococcus agalactiae	无乳链球菌	G+
g__Streptococcus;s__oralis	Streptococcus oralis	口腔链球菌	G+
g__Streptococcus;s__acidominimus	Streptococcus acidominimus	少酸链球菌	G+
g__Streptococcus;s__haemolyticus	Streptococcus haemolyticus	溶血链球菌	G+
g__Streptococcus;s__mitis	Streptococcus mitis	缓症链球菌	G+
